#####################
#        #   ########
######       #  ##  #
#        #   #  #   #
#        #   #  #   #
#   ######      #   |
#   # # ### ######  #
#   #   #        ## ##
|       #   ####    #
####  # #       ######
#       #   #  ##   #
#       #   #    #  #
#####################